20 16 16 16 16 16 16 16 16 16 16 16 16 16 16 16 16 16 16 16 16 16 16 18
00 22 01 22 01 01 04 01 22 01 01 01 22 01 01 01 01 04 01 01 01 01 01 25
00 01 01 02 01 01 04 01 01 01 01 01 02 01 01 01 01 04 01 01 02 01 01 25
00 01 01 22 01 01 04 01 01 22 01 01 01 22 01 22 01 04 01 22 01 01 01 25
00 06 06 06 06 06 10 01 01 01 01 23 01 01 01 01 01 04 01 22 01 01 01 25
00 01 01 01 01 02 04 01 01 01 02 01 01 09 06 06 06 05 06 06 06 06 06 25
00 01 22 01 01 01 04 01 23 01 22 01 01 04 01 01 01 04 01 23 01 01 01 25
00 01 01 01 01 01 04 01 01 22 01 01 01 04 01 01 01 03 06 06 06 07 01 25
00 01 02 01 01 01 03 06 06 06 06 06 06 08 06 07 01 02 01 01 01 04 01 25
00 01 01 22 01 01 01 01 01 01 01 22 01 01 01 04 01 01 01 22 01 04 01 25
00 01 01 01 01 01 23 02 01 01 01 01 01 01 01 04 01 23 02 01 01 04 01 25
00 01 01 01 22 01 01 01 01 01 01 01 22 01 01 04 01 01 22 01 01 04 01 25
19 24 24 24 24 24 24 24 24 24 24 24 24 24 24 24 24 24 24 24 24 24 24 17